1111111111111111
1P000000000000C1
1000011111111001
1C00000000000001
1000111111111101
100000C000000001
1000000000E00001
1111111111111111